11111
1PCC1
10001
1E001
100F1
11111