11111111111111111
100C1000000100011
10000000000000111
1000000PC100001E1
10000000000000111
10001C00000100011
11111111111111111