111111111111111111111111111111111
100000000000000000000000000000001
101111101000101000000111001000101
101000000101001000001000101100101
101110000010001000001000101010101
101000000010001000001000101001101
101111100010001111100111001000101
100000000000000000000000000000001
10C0C0CCC0P0000000000000000000001
10C0C000C000000000000000000000001
10CCC0CCC000000000000000000000001
1000C0C00000000000000000000000001
1000C0CCC000000000000000000000E01
100000000000000000000000000000001
111111111111111111111111111111111