1111111111
1000000001
10P0E00C01
1000000001
1111000111