1111111111
1001000001
10P1000E011
1001000001
1111001111