11111111111111111111111111111111111111111111111111
111111000000000P0000000000000000000000000000000011
11100000000000000000000000000000000000000000000011
10000000000000000000000000000000000000000000000011
111000000000000C0E00000000000000000000000000000111
11111111111111111111111111111111111111111110000011
11000000000000000000000000000000000000000000000011
11111111111111111111111111111111111111111111111111
