111111
1PCC01
100001
1E0001
100FF1
111111