11111111111
101C10000C1
1000CC01101
1000101C111
10E0P00C101
10001C010C1
11111111111